Maze x - 5 5
#####
#    
#   #
P   #
#####

Maze x - 7 8
########
P      #
###### #
#      #
# ######
#      #
######D#
